compose	kəmˈpəʊz
clearinghouse	ˈklɪərɪŋhaʊs
reuse	riːˈjuːz
elapse	ɪˈlæps
encase	ɪnˈkeɪs
demise	dɪˈmaɪz
spouse	spaʊz
perverse	pəˈvɜːs
suffuse	səˈfjuːz
release	rɪˈliːs
suspense	səsˈpɛns
advertise	ˈædvətaɪz
cheese	ʧiːz
grouse	ɡraʊs
discourse	dɪsˈkɔːs
showcase	ˈʃəʊkeɪs
analyse	ˈænəlaɪz
glucose	ˈɡluːkəʊs
dispense	dɪsˈpɛns
terse	tɜːs
townhouse	ˈtaʊnhaʊs
those	ðəʊz
else	ɛls
multipurpose	ˌmʌltɪˈpɜːpəs
pose	pəʊz
traverse	trəˈvɜːs
finesse	fɪˈnɛs
reimburse	ˌriːɪmˈbɜːs
nose	nəʊz
pulse	pʌls
advise	ədˈvaɪz
staircase	ˈsteəkeɪs
increase	ˈɪnkriːs
grease	ɡriːs
license	ˈlaɪsəns
likewise	ˈlaɪkwaɪz
immense	ɪˈmɛns
case	keɪs
clause	klɔːz
peruse	pəˈruːz
suitcase	ˈsjuːtkeɪs
treatise	ˈtriːtɪz
corpse	kɔːps
precise	prɪˈsaɪs
dose	dəʊs
arise	əˈraɪz
concourse	ˈkɒŋkɔːs
converse	kənˈvɜːs
noise	nɔɪz
pretense	prɪˈtɛns
franchise	ˈfrænʧaɪz
appraise	əˈpreɪz
powerhouse	ˈpaʊəhaʊs
disease	dɪˈziːz
lapse	læps
reverse	rɪˈvɜːs
prose	prəʊz
lease	liːs
rinse	rɪns
praise	preɪz
mayonnaise	ˌmeɪəˈneɪz
televise	ˈtɛlɪvaɪz
vase	vɑːz
purpose	ˈpɜːpəs
overdose	ˈəʊvədəʊs
malaise	mæˈleɪz
promise	ˈprɒmɪs
defense	dɪˈfɛns
course	kɔːs
browse	braʊz
hoarse	hɔːs
lighthouse	ˈlaɪthaʊs
lacrosse	ləˈkrɒs
these	ðiːz
bookcase	ˈbʊkkeɪs
database	ˈdeɪtəˌbeɪs
horse	hɔːs
intersperse	ˌɪntəˈspɜːs
eclipse	ɪˈklɪps
sparse	spɑːs
coffeehouse	ˈkɒfɪhaʊs
apocalypse	əˈpɒkəlɪps
merchandise	ˈmɜːʧəndaɪz
disguise	dɪsˈɡaɪz
defuse	ˌdiːˈfjuːz
obese	əʊˈbiːs
remorse	rɪˈmɔːs
diverse	daɪˈvɜːs
relapse	rɪˈlæps
suppose	səˈpəʊz
workhorse	ˈwɜːkhɔːs
noose	nuːs
enthuse	ɪnˈθjuːz
pillowcase	ˈpɪləʊkeɪs
pause	pɔːz
menopause	ˈmɛnəʊpɔːz
repose	rɪˈpəʊz
depose	dɪˈpəʊz
penthouse	ˈpɛnthaʊs
paradise	ˈpærədaɪs
muse	mjuːz
infuse	ɪnˈfjuːz
greenhouse	ˈɡriːnhaʊs
nonsense	ˈnɒnsəns
louse	laʊs
collapse	kəˈlæps
response	rɪsˈpɒns
rehearse	rɪˈhɜːs
incense	ˈɪnsɛns
abuse	əˈbjuːs
applause	əˈplɔːz
base	beɪs
clockwise	ˈklɒkwaɪz
archdiocese	ˌɑːʧˈdaɪəsɪs
impasse	æmˈpɑːs
overuse	ˌəʊvəˈjuːz
please	pliːz
tense	tɛns
otherwise	ˈʌðəwaɪz
inverse	ɪnˈvɜːs
crosswise	ˈkrɒswaɪz
expose	ɪksˈpəʊz
phase	feɪz
posse	ˈpɒsi
tease	tiːz
rouse	raʊz
crease	kriːs
propose	prəˈpəʊz
coarse	kɔːs
enterprise	ˈɛntəpraɪz
raise	reɪz
condense	kənˈdɛns
curse	kɜːs
goose	ɡuːs
diocese	ˈdaɪəsɪs
erase	ɪˈreɪz
adverse	ˈædvɜːs
comatose	ˈkəʊmətəʊs
verse	vɜːs
farmhouse	ˈfɑːmhaʊs
superimpose	ˈsuːpərɪmˈpəʊz
blouse	blaʊz
disclose	dɪsˈkləʊz
juxtapose	ˈʤʌkstəpəʊz
briefcase	ˈbriːfˌkeɪs
douse	daʊs
cruise	kruːz
cause	kɔːz
misuse	ˌmɪsˈjuːs
endorse	ɪnˈdɔːs
disperse	dɪsˈpɜːs
nurse	nɜːs
revise	rɪˈvaɪz
impulse	ˈɪmpʌls
chase	ʧeɪs
warehouse	ˈweəhaʊs
amuse	əˈmjuːz
glimpse	ɡlɪmps
unease	ˌʌnˈiːz
unwise	ʌnˈwaɪz
devise	dɪˈvaɪz
phrase	freɪz
immerse	ɪˈmɜːs
clubhouse	ˈklʌbˌhaʊs
parse	pɑːz
comprise	kəmˈpraɪz
sunrise	ˈsʌnraɪz
use	juːz
fuse	fjuːz
expertise	ˌɛkspɜːˈtiːz
slaughterhouse	ˈslɔːtəhaʊs
excuse	ɪksˈkjuːs
expanse	ɪksˈpæns
exercise	ˈɛksəsaɪz
accuse	əˈkjuːz
poise	pɔɪz
cease	siːs
confuse	kənˈfjuːz
house	haʊs
offense	əˈfɛns
surmise	sɜːˈmaɪz
enclose	ɪnˈkləʊz
refuse	ˌriːˈfjuːz
predispose	ˌpriːdɪsˈpəʊz
schoolhouse	ˈskuːlhaʊs
hose	həʊz
premise	ˈprɛmɪs
close	kləʊs
purchase	ˈpɜːʧəs
intense	ɪnˈtɛns
excise	ɛkˈsaɪz
concise	kənˈsaɪs
whose	huːz
grandiose	ˈɡrændɪəʊs
paraphrase	ˈpærəfreɪz
recourse	rɪˈkɔːs
expense	ɪksˈpɛns
choose	ʧuːz
ruse	ruːz
purse	pɜːs
sense	sɛns
mousse	muːs
arouse	əˈraʊz
lengthwise	ˈlɛŋθwaɪz
dense	dɛns
courthouse	ˈkɔːtˈhaʊs
repulse	rɪˈpʌls
diagnose	ˈdaɪəɡnəʊz
guise	ɡaɪz
foreclose	fɔːˈkləʊz
presuppose	ˌpriːsəˈpəʊz
compromise	ˈkɒmprəmaɪz
rose	rəʊz
chastise	ʧæsˈtaɪz
appease	əˈpiːz
turquoise	ˈtɜːkwɑːz
supervise	ˈsuːpəvaɪz
impose	ɪmˈpəʊz
oppose	əˈpəʊz
surprise	səˈpraɪz
outhouse	ˈaʊthaʊs
wise	waɪz
cleanse	klɛnz
dispose	dɪsˈpəʊz
bruise	bruːz
rise	raɪz
loose	luːs
intercourse	ˈɪntəkɔːs
improvise	ˈɪmprəvaɪz
moose	muːs
ease	iːz
decrease	ˈdiːkriːs
universe	ˈjuːnɪvɜːs
decompose	ˌdiːkəmˈpəʊz
lose	luːz
espouse	ɪsˈpaʊz
diffuse	dɪˈfjuːs
because	bɪˈkɒz
despise	dɪsˈpaɪz
tortoise	ˈtɔːtəs
mouse	maʊs