acquaintance	NN1	acquaintance
audience	NN1	audience
inexperience	NN1	inexperience
entrance	NN1	entrance
once	AV0	once
resistance	NN1	resistance
dice	NN0	dice
police	NN2	police
absence	NN1	absence
necklace	NN1	necklace
advance	NN1	advance
outpace	VVB	outpace
choice	NN1	choice
lettuce	NN1	lettuce
relevance	NN1	relevance
deference	NN1	deference
retrace	VVB	retrace
exuberance	NN1	exuberance
piece	NN1	piece
decadence	NN1	decadence
eyepiece	NN1	eyepiece
acceptance	NN1	acceptance
dance	NN1	dance
accordance	NN1	accordance
incidence	NN1	incidence
trace	NN1	trace
patience	NN1	patience
rejoice	VVB	rejoice
reminiscence	NN1	reminiscence
freelance	NN1	freelance
bodice	NN1	bodice
annoyance	NN1	annoyance
justice	NN1	justice
suffice	VVB	suffice
spruce	NN0	spruce
influence	NN1	influence
violence	NN1	violence
coerce	VVB	coerce
juice	NN1	juice
mince	VVB	mince
lance	NN1	lance
reintroduce	VVB	reintroduce
brace	VVB	brace
precipice	NN1	precipice
centerpiece	NN1	centerpiece
presence	NN1	presence
circumference	NN1	circumference
practice	NN1	practice
preface	NN1	preface
negligence	NN1	negligence
substance	NN1	substance
vengeance	NN1	vengeance
subsistence	NN1	subsistence
niece	NN1	niece
office	NN1	office
renaissance	NN1	renaissance
furnace	NN1	furnace
whence	AVQ	whence
credence	NN1	credence
reconnaissance	NN1	reconnaissance
reinforce	VVB	reinforce
repentance	NN1	repentance
misplace	VVB	misplace
parlance	NN1	parlance
sentence	NN1	sentence
deterrence	NN1	deterrence
coalesce	VVB	coalesce
residence	NN1	residence
renounce	VVI	renounce
advice	NN1	advice
romance	NN1	romance
commence	VVB	commence
stance	NN1	stance
denounce	VVI	denounce
arrogance	NN1	arrogance
dominance	NN1	dominance
ambivalence	NN1	ambivalence
interference	NN1	interference
severance	NN1	severance
convergence	NN1	convergence
observance	NN1	observance
variance	NN1	variance
nice	AJ0	nice
reliance	NN1	reliance
coincidence	NN1	coincidence
deduce	VVB	deduce
sacrifice	NN1	sacrifice
convenience	NN1	convenience
commerce	NN1	commerce
performance	NN1	performance
glance	VVB	glance
solstice	NN1	solstice
solace	NN1	solace
disobedience	NN1	disobedience
finance	NN1	finance
adolescence	NN1	adolescence
impotence	NN1	impotence
extravagance	NN1	extravagance
neuroscience	NN1	neuroscience
intolerance	NN1	intolerance
emergence	NN1	emergence
ordnance	NN1	ordnance
experience	NN1	experience
jurisprudence	NN1	jurisprudence
injustice	NN1	injustice
place	NN1	place
reduce	VVB	reduce
sauce	NN1	sauce
hindrance	NN1	hindrance
independence	NN1	independence
fence	NN1	fence
pronounce	VVB	pronounce
persistence	NN1	persistence
trance	NN1	trance
silence	NN1	silence
convince	VVB	convince
menace	NN1	menace
announce	VVI	announce
acquiesce	VVI	acquiesce
airspace	NN1	airspace
anyplace	NN1	anyplace
assurance	NN1	assurance
importance	NN1	importance
source	NN1	source
divorce	NN1	divorce
occurrence	NN1	occurrence
enforce	VVB	enforce
reference	NN1	reference
compliance	NN1	compliance
ordinance	NN1	ordinance
alliance	NN1	alliance
interdependence	NN1	interdependence
congruence	NN1	congruence
bounce	VVB	bounce
allowance	NN1	allowance
cadence	NN1	cadence
commonplace	AJ0	commonplace
provenance	NN1	provenance
utterance	NN1	utterance
enhance	VVB	enhance
dissonance	NN1	dissonance
prejudice	NN1	prejudice
populace	NN1	populace
auspice	NN1	auspice
indifference	NN1	indifference
semblance	NN1	semblance
face	NN1	face
resemblance	NN1	resemblance
disappearance	NN1	disappearance
accomplice	NN1	accomplice
assistance	NN1	assistance
salience	NN1	salience
radiance	NN1	radiance
appliance	NN1	appliance
palace	NN1	palace
countenance	NN1	countenance
marketplace	NN1	marketplace
science	NN1	science
hospice	NN1	hospice
defiance	NN1	defiance
insurance	NN1	insurance
governance	NN1	governance
resilience	NN1	resilience
scarce	AJ0	scarce
fierce	AJ0	fierce
spice	NN1	spice
divergence	NN1	divergence
reluctance	NN1	reluctance
force	NN1	force
essence	NN1	essence
splice	NN1	splice
circumstance	NN1	circumstance
entice	VVB	entice
diligence	NN1	diligence
crevice	NN1	crevice
invoice	NN1	invoice
obedience	NN1	obedience
correspondence	NN1	correspondence
sustenance	NN1	sustenance
recurrence	NN1	recurrence
disservice	NN1	disservice
mouthpiece	NN1	mouthpiece
disturbance	NN1	disturbance
surveillance	NN1	surveillance
grace	NN1	grace
fragrance	NN1	fragrance
inheritance	NN1	inheritance
conference	NN1	conference
voice	NN1	voice
remittance	NN1	remittance
inconvenience	NN1	inconvenience
indulgence	NN1	indulgence
twice	AV0	twice
reminisce	VVB	reminisce
outsource	VVB	outsource
counterbalance	VVB	counterbalance
resurgence	NN1	resurgence
brilliance	NN1	brilliance
pierce	VVB	pierce
avoidance	NN1	avoidance
sequence	NN1	sequence
consequence	NN1	consequence
difference	NN1	difference
resurface	VVB	resurface
competence	NN1	competence
confluence	NN1	confluence
introduce	VVB	introduce
birthplace	NN1	birthplace
replace	VVB	replace
hence	AV0	hence
lace	NN1	lace
allegiance	NN1	allegiance
imbalance	NN1	imbalance
excellence	NN1	excellence
nuisance	NN1	nuisance
preference	NN1	preference
reticence	NN1	reticence
peace	NN1	peace
cowardice	NN1	cowardice
someplace	AV0	someplace
pace	NN1	pace
terrace	NN1	terrace
deliverance	NN1	deliverance
evince	VVB	evince
wince	VVB	wince
fireplace	NN1	fireplace
insistence	NN1	insistence
abundance	NN1	abundance
instance	NN1	instance
embrace	VVB	embrace
eloquence	NN1	eloquence
reproduce	VVB	reproduce
malice	NN1	malice
equivalence	NN1	equivalence
adherence	NN1	adherence
permanence	NN1	permanence
induce	VVB	induce
service	NN1	service
resource	NN1	resource
coherence	NN1	coherence
precedence	NN1	precedence
apprentice	NN1	apprentice
cyberspace	NN1	cyberspace
grievance	NN1	grievance
fleece	NN1	fleece
abstinence	NN1	abstinence
edifice	NN1	edifice
device	NN1	device
interface	NN1	interface
slice	NN1	slice
existence	NN1	existence
truce	NN1	truce
aerospace	NN1	aerospace
since	PRP	since
preponderance	NN1	preponderance
tolerance	NN1	tolerance
ace	NN1	ace
condolence	NN1	condolence
apiece	AV0	apiece
innocence	NN1	innocence
balance	NN1	balance
dependence	NN1	dependence
distance	NN1	distance
elegance	NN1	elegance
ignorance	NN1	ignorance
guidance	NN1	guidance
race	NN1	race
incompetence	NN1	incompetence
grimace	VVB	grimace
vice	NN1	vice
resonance	NN1	resonance
attendance	NN1	attendance
pounce	VVB	pounce
ambience	NN1	ambience
confidence	NN1	confidence
remembrance	NN1	remembrance
refinance	VVB	refinance
displace	VVI	displace
prudence	NN1	prudence
artifice	NN1	artifice
penance	NN1	penance
significance	NN1	significance
workplace	NN1	workplace
endurance	NN1	endurance
prince	NN1	prince
perseverance	NN1	perseverance
intelligence	NN1	intelligence
inference	NN1	inference
chance	NN1	chance
nuance	NN1	nuance
masterpiece	NN1	masterpiece
lattice	NN1	lattice
seduce	VVB	seduce
prevalence	NN1	prevalence
province	NN1	province
rice	NN1	rice
affluence	NN1	affluence
transcendence	NN1	transcendence
impatience	NN1	impatience
space	NN1	space
benevolence	NN1	benevolence
acquiescence	NN1	acquiescence
reassurance	NN1	reassurance
prominence	NN1	prominence
evidence	NN1	evidence
vigilance	NN1	vigilance
workforce	NN1	workforce
notice	VVB	notice
incontinence	NN1	incontinence
ambulance	NN1	ambulance
malpractice	NN1	malpractice
disgrace	NN1	disgrace
ice	NN1	ice
price	NN1	price
appearance	NN1	appearance
conscience	NN1	conscience
farce	NN1	farce
reverence	NN1	reverence
surface	NN1	surface
novice	NN1	novice
clearance	NN1	clearance
maintenance	NN1	maintenance
produce	VVB	produce
turbulence	NN1	turbulence
