compose	VVB	compose
clearinghouse	NN1	clearinghouse
reuse	VVB	reuse
elapse	VVB	elapse
encase	VVB	encase
demise	NN1	demise
spouse	NN1	spouse
perverse	AJ0	perverse
suffuse	VVB	suffuse
release	VVB	release
suspense	NN1	suspense
advertise	VVB	advertise
cheese	NN1	cheese
grouse	NN0	grouse
discourse	NN1	discourse
showcase	NN1	showcase
analyse	VVB	analyse
glucose	NN1	glucose
dispense	VVB	dispense
terse	AJ0	terse
townhouse	NN1	townhouse
those	DT0	those
else	AV0	else
multipurpose	AJ0	multipurpose
pose	VVB	pose
traverse	VVB	traverse
finesse	NN1	finesse
reimburse	VVB	reimburse
nose	NN1	nose
pulse	NN1	pulse
advise	VVB	advise
staircase	NN1	staircase
increase	VVB	increase
grease	NN1	grease
license	NN1	license
likewise	AV0	likewise
immense	AJ0	immense
case	NN1	case
clause	NN1	clause
peruse	VVB	peruse
suitcase	NN1	suitcase
treatise	NN1	treatise
corpse	NN1	corpse
precise	AJ0	precise
dose	NN1	dose
arise	VVB	arise
concourse	NN1	concourse
converse	VVB	converse
noise	NN1	noise
pretense	NN1	pretense
franchise	NN1	franchise
appraise	VVB	appraise
powerhouse	NN1	powerhouse
disease	NN1	disease
lapse	NN1	lapse
reverse	VVB	reverse
prose	NN1	prose
lease	NN1	lease
rinse	NN1	rinse
praise	VVB	praise
mayonnaise	NN1	mayonnaise
televise	VVB	televise
vase	NN1	vase
purpose	NN1	purpose
overdose	NN1	overdose
malaise	NN1	malaise
promise	VVB	promise
defense	NN1	defense
course	NN1	course
browse	VVB	browse
hoarse	AJ0	hoarse
lighthouse	NN1	lighthouse
lacrosse	NN1	lacrosse
these	DT0	these
bookcase	NN1	bookcase
database	NN1	database
horse	NN1	horse
intersperse	VVB	intersperse
eclipse	NN1	eclipse
sparse	AJ0	sparse
coffeehouse	NN1	coffeehouse
apocalypse	NN1	apocalypse
merchandise	NN1	merchandise
disguise	VVB	disguise
defuse	VVB	defuse
obese	AJ0	obese
remorse	NN1	remorse
diverse	AJ0	diverse
relapse	NN1	relapse
suppose	VVB	suppose
workhorse	NN1	workhorse
noose	NN1	noose
enthuse	VVB	enthuse
pillowcase	NN1	pillowcase
pause	VVB	pause
menopause	NN1	menopause
repose	NN1	repose
depose	VVB	depose
penthouse	NN1	penthouse
paradise	NN1	paradise
muse	VVB	muse
infuse	VVB	infuse
greenhouse	NN1	greenhouse
nonsense	NN1	nonsense
louse	NN1	louse
collapse	VVB	collapse
response	NN1	response
rehearse	VVB	rehearse
incense	NN1	incense
abuse	NN1	abuse
applause	NN1	applause
base	VVB	base
clockwise	AJ0	clockwise
archdiocese	NN1	archdiocese
impasse	NN1	impasse
overuse	NN1	overuse
please	AV0	please
tense	AJ0	tense
otherwise	AV0	otherwise
inverse	AJ0	inverse
crosswise	AJ0	crosswise
expose	VVB	expose
phase	NN1	phase
posse	NN1	posse
tease	VVB	tease
rouse	VVB	rouse
crease	NN1	crease
propose	VVB	propose
coarse	AJ0	coarse
enterprise	NN1	enterprise
raise	VVB	raise
condense	VVB	condense
curse	VVB	curse
goose	NN1	goose
diocese	NN1	diocese
erase	VVB	erase
adverse	AJ0	adverse
comatose	AJ0	comatose
verse	NN1	verse
farmhouse	NN1	farmhouse
superimpose	VVB	superimpose
blouse	NN1	blouse
disclose	VVB	disclose
juxtapose	VVB	juxtapose
briefcase	NN1	briefcase
douse	VVB	douse
cruise	NN1	cruise
cause	NN1	cause
misuse	NN1	misuse
endorse	VVB	endorse
disperse	VVB	disperse
nurse	NN1	nurse
revise	VVB	revise
impulse	NN1	impulse
chase	VVB	chase
warehouse	NN1	warehouse
amuse	VVB	amuse
glimpse	NN1	glimpse
unease	NN1	unease
unwise	AJ0	unwise
devise	VVB	devise
phrase	NN1	phrase
immerse	VVB	immerse
clubhouse	NN1	clubhouse
parse	VVB	parse
comprise	VVB	comprise
sunrise	NN1	sunrise
use	VVB	use
fuse	NN1	fuse
expertise	NN1	expertise
slaughterhouse	NN1	slaughterhouse
excuse	VVB	excuse
expanse	NN1	expanse
exercise	NN1	exercise
accuse	VVB	accuse
poise	VVB	poise
cease	VVI	cease
confuse	VVI	confuse
house	NN1	house
offense	NN1	offense
surmise	VVB	surmise
enclose	VVB	enclose
refuse	VVB	refuse
predispose	VVB	predispose
schoolhouse	NN1	schoolhouse
hose	NN1	hose
premise	NN1	premise
close	VVB	close
purchase	VVB	purchase
intense	AJ0	intense
excise	NN1	excise
concise	AJ0	concise
whose	DTQ	whose
grandiose	AJ0	grandiose
paraphrase	VVB	paraphrase
recourse	NN1	recourse
expense	NN1	expense
choose	VVB	choose
ruse	NN1	ruse
purse	NN1	purse
sense	NN1	sense
mousse	NN1	mousse
arouse	VVB	arouse
lengthwise	AV0	lengthwise
dense	AJ0	dense
courthouse	NN1	courthouse
repulse	VVB	repulse
diagnose	VVB	diagnose
guise	NN1	guise
foreclose	VVI	foreclose
presuppose	VVB	presuppose
compromise	NN1	compromise
rose	NN1	rose
chastise	VVB	chastise
appease	VVB	appease
turquoise	AJ0	turquoise
supervise	VVI	supervise
impose	VVI	impose
oppose	VVI	oppose
surprise	NN1	surprise
outhouse	NN1	outhouse
wise	AJ0	wise
cleanse	VVB	cleanse
dispose	VVB	dispose
bruise	NN1	bruise
rise	VVB	rise
loose	AJ0	loose
intercourse	NN1	intercourse
improvise	VVB	improvise
moose	NN0	moose
ease	VVB	ease
decrease	VVB	decrease
universe	NN1	universe
decompose	VVB	decompose
lose	VVB	lose
espouse	VVB	espouse
diffuse	VVB	diffuse
because	CJS	because
despise	VVB	despise
tortoise	NN1	tortoise
mouse	NN1	mouse
